                                                          #################################
                                                          #...............................#
                                                          #...............................#
                                                          #...............................#
                                                          #...............................#
                                                          #...............................#
                                                          #...............................#
                                                          #...............................#
                                                #######   #...............................#
#######################################         #.....#   #...............................#
#.....................................#         #.....#   #...............................#
#.....................................#         #.....#   #...............................#
#.....................................#         #.....#   #...............................#
#.....................................#         +=========+...............................#
#.....................................#         #.....#   #...............................#
#.....................................#         #.....#   #...............................#
#.....................................#         #.....#   #...............................#
#.....................................#         #.....#   #...............................#
#.....................................#         #.....#   #...............................#
#.....................................#         #.....#   #...............................#
#.....................................#         #.....#   #...............................#
#.....................................#         #.....#   #...............................#
#.....................................#         #.....#   #...............................#
#.....................................#         #.....#   #...............................#
#.....................................#         #.....#   #...............................#
#.....................................#         #.....#   #...............................#
#.....................................-=========-.....#   #################################
#.....................................#         ###-###                                    
#.....................................#            =                                       
#.....................................#            =                                       
#.....................................#            =                                       
#.....................................#            =                                       
#.....................................#            =                                       
#.....................................#            =                                       
#.....................................#            =                                       
#.....................................#            =                                       
#.....................................#            =                                       
#.....................................#            -#######################                
#.....................................#            #......................#                
#.....................................#            #......................#                
#.....................................#            #......................#                
#.....................................#            #......................#                
#.....................................#            #......................#                
#######################################            #......................#                
                                                   #......................#                
                                                   #......................#                
                                                   #......................#                
                                                   #......................#                
                                                   #......................#                
                                                   #......................#                
                                                   #......................#                
                                                   #......................#                
                                                   #......................#                
                                                   #......................#                
                                                   #......................#                
                                                   #......................#                
                                                   #......................#                
                                                   #......................#                
                                                   #......................#                
                                                   ########################                
