                                                                                  ###########                                                                                                   
                                                                                  #.........#                                                                                                   
                                                                                  #.........#                                                                                                   
                                                                                  #.........#                                                                                                   
                                                                                  #.........#                                                                                                   
                                                                                  #.........#                                                                                                   
                                                                                  #.........#                                                                                                   
###########################################                                       #.........#                                                                                                   
#.........................................#                                       #.........#                                                                                                   
#.........................................#                                       #.........#                                                                                                   
#.........................................#                                       #.........#                                                                                                   
#.........................................#          ###################          #.........###############                                                                                     
#.........................................#          #.................#          #.........#.............#                                                                                     
#.........................................#          #.................#          #.........#.............#                                                                                     
#.........................................#          #.................#          #.........#.............#                                                                                     
#.........................................#          #.................#          #.........#.............#                                                                                     
#.........................................#          #.................#          #.........#.............#                                                                                     
#.........................................#          #.................#          #.........#.............#                                                                                     
#.........................................#          #.................#          #.........#.............#                                                                                     
#.........................................#          #.................#          #.........#.............#                                                                                     
#.........................................#          #.................#          #.........#.............#                                                                                     
#.........................................#          #.................-==========-.........#.............#                                                                                     
#.........................................#          #.................#          #.........#.............#                                                                                     
#.........................................#          #.................#          #.........#.............#                                                                                     
#.........................................#          #.................#          #.........#.............#                                                                                     
#.........................................#          #.................#          #.........#.............#                                                                                     
#.........................................#          #.................#          #.........#.............#                                                                                     
#.........................................#          #.................#          #.........#.............#                                                                                     
#.........................................#          #.................#          #.........#.............#                                                                                     
#.........................................#          #.................#          #.........#.............#                                                                                     
#.........................................+==========+.................#          #.........#.............#                                                                                     
#.........................................#          ###################          #.........#.............#                                                                                     
#.........................................#                                       #.........#.............#                                                                                     
#.........................................#                                       #.........#.............#                                                                                     
#.........................................#                                       #.........#.............#                                                                                     
#.........................................#                                       #.........#.............#                                                                                     
#.........................................#                                       #.........#.............#                                                                                     
#.........................................#                                       #.........#.............#                                                                                     
#.........................................#                                       #.........#.............#                                                                                     
#.........................................#                                       #.........#.............#                                                                                     
#.........................................#                                       #.........#.............#                                                                                     
#.........................................#                                       #.........#######+#######                                                                                     
#.........................................#                                       #####+#####      =                                                                                            
#.........................................#                                            =           =                                                                                            
#.........................................#                                            =           =                                                                                            
#.........................................#                                            =           =                                                                                            
#.........................................#                                            =           =                                                                                            
#.........................................#                                            =           =                                                                                            
#.........................................#                                            =           =                                                                                            
#.........................................#                                            =     ######=                                                                                            
#.........................................#                                            =     #.....=                                                                                            
#.........................................#                                            =     #.....=                                                                                            
#.........................................#                                            =     #.....+                                                                                            
###########################################    ########################################+######.....#                                                                                            
                                               #.............................................#.....#                                                                                            
                                               #.............................................#.....#                                                                                            
                                               #.............................................#.....#                                                                      ######################
                                               #.............................................#.....#                                                                      #....................#
                                               #.............................................#.....#                                                                      #....................#
                                               #.............................................#.....#                                                                      #....................#
                                               #.............................................#.....#                                                                      #....................#
                                               #.............................................#.....#                                                                      #....................#
                                               #.............................................#.....#                                                                      #....................#
                                               #.............................................#.....#                                                                      #....................#
                                               #.............................................#.....#                                                                      #....................#
                                               #.............................................#.....#    #################################                                 #....................#
                                               #.............................................#.....#    #...............................#                                 #....................#
                                               #.............................................#.....#    #...............................#                                 #....................#
                                               #.............................................#.....#    #...............................#                                 #....................#
                                               #.............................................-==========-...............................#                                 #....................#
                                               #.............................................#.....#    #...............................#                                 #....................#
                                               #.............................................#.....#    #...............................#        ##############-==========-....................#
                                               #.............................................#.....#    #...............................#        #...................#    #....................#
                                               #.............................................#==========-...............................#        #...................#    #....................#
                                               #.............................................#.....#    #...............................#        #...................#    #....................#
                                               #.............................................#.....#    #...............................#        #...................#    #....................#
                                               #.............................................#.....#    #...............................#        #...................#    #....................#
                                               #.............................................#.....#    #...............................#        #...................#    #....................#
                                               #.............................................#.....#    #...............................#        #...................#    #....................#
                                               #.............................................#.....#    #...............................#        #...................#    #....................#
                                               #.............................................#.....#    #...............................#        #...................#    #....................#
                                               #.............................................#.....#    ##############################-==========-...................#    #....................#
                                               #.............................................#.....#                                             #...................#    #....................#
                                               #.............................................#.....#                                             #...................#    #....................#
                                               #.............................................#.....#                                             #...................#    #....................#
                                               ###############################################.....#                                             #...................#    #....................#
                                                                                             #.....#                                             #...................#    ######################
                                                                                             #.....#                                             #...................#                          
                                                                                             #.....#                                             #...................#                          
                                                                                             #.....#                                             #...................#                          
                                                                                             ###+###                                             #...................#                          
                                                                                                =                                                #####################                          
                                                                                                =                                         ###########                                           
                                                                                                =                                         #.........#                                           
                                                                                                =                                         #.........#                                           
                                                                                                =                                         #.........#                                           
                                                                                                =                                         #.........#                                           
                                                                                                =                                         #.........#                                           
                                                                                                =                                         #.........#                                           
                                                                                                =                                         #.........#                                           
                                                                                                =                                         #.........#                                           
                                                                                                +######################                   #.........#                                           
                                                                                                #.....................#                   #.........#                                           
                                                                                                #.....................#                   #.........#                                           
                                                                                                #.....................#                   #.........#                                           
                                                                                                #.....................#                   #.........#                                           
                                                                    ########################### #.....................#                   #.........#                                           
                                                                    #.........................# #.....................#                   #.........#                                           
                                                                    #.........................# #.....................#                   #.........#                                           
                                                                    #.........................# #.....................#                   #####+#####                                           
                                                                    #.........................# #.....................#                        =                                                
                                                                    #.........................# #.....................#                        =                                                
                                                                    #.........................# #.....................#                        =                                                
                                                                    #############+############# #.....................#                        =                                                
                                                                                 =              #.....................#                        =                                                
                                                                                 =              #.....................#                        =                                                
                                                                                 =              #.....................#    ####################=                                                
                                                                                 =              #.....................#    #...................=                                                
                                                                                 =###############.....................#    #...................=                                                
                                                                                 =..............#.....................#    #...................=                                                
                                                                                 =..............#.....................#    #...................+                                                
                                                                                 =..............#.....................#    #...................#                                                
                                                                                 =..............#.....................#    #...................#                                                
                                                                                 =..............#.....................#    #...................#                                                
                                                                                 +..............-==========-####-==========-...................#                                                
                                                                                 #..............#                          #...................#                                                
                                                                                 #..............#                          #...................#                                                
                                                                                 #..............#                          #...................#                                                
                                                                                 #..............#                          #...................#                                                
                                                                                 #..............#                          #...................#                                                
                                                                                 ################                          #...................#                                                
                                                                                                                           #...................#                                                
                                                                                                                           #####################                                                
